11111111111111111111111
1E00000Z0000000C0000C01
1010010100100Z010100101
10100100101010100100101
1P000Z000C00C000Z000001
11111111111111111111111