11111111111
10000000001
1000P00E001
1C000000001
10000000001
10C00000001
11111111111