1111111111111111
100011C000111001
110Z00001000C001
111E000000P00111
1111111111111111