11111
1C0Z1
11001
10011
100P1
1E011
11111